NO ./path_to_north_texture
SO ./path_to_south_texture
WE ./path_to_west_texture
EA ./path_to_east_texture

F 220,100,0 //floor
C 220,100,0 //ceiling

    1111111111111111111111111111111
11110000000000000000000000000000001
10000000000000000000000000000000001
10000000000000000000000000000000001
10000000000000000000000000000000001
11000000000000000000000000000000001
10000000000000000000000000100000001
10000000000000000000000001 10000001
10000000000000000000000001 10000001
1100000000000000N000000001 10001111
11111111111111111111111111 1111