NO	./textures/blue.xpm
SO	./textures/green.xpm
WE	./textures/rose.xpm          
EA	./textures/red.xpm        	  

C 0,180,220
F 220,100,0

    1111111111111111111111111111111
11110000000000000000000000000000001
10000000000000000000000000000000001
10000000000000000000000000000000001
10000000000000000000000000000000001
11000000000001100111100000000000001
10000000000001100000100000100000001
10000000000000000000100001 10000001
10000000000000000000100001 10000001
1100000000000000N000100001 10001111
11111111111111111111111111 1111
