NO	./textures/Grass_03.xpm   
SO	./textures/Grass_03.xpm    
WE	./textures/stone.xpm          
EA	./textures/Grass_04.xpm
F 102,205,170
C 70,130,190

 1111111        111111111
110000011      10000000001
100000001     1000000000001
 1000001     100000000000001
  11011      1000000000000001
   101        1000000100000001
   101         100001 100000001
   101111111111100000100000001
   10000000000000000000000001
   1011111111111000000000001
   101         100000000001
   101        100000000001
  11011      1000000000001
 1000001     1000000000001
100000001     100000S0001
110000011      1000000001
 1111111        111111111
