NO	./textures/Grass_03.xpm   
SO	./textures/Grass_03.xpm    
WE	./textures/stone.xpm          
EA	./textures/Grass_04.xpm     
F 102,205,170
C 70,130,180


111111111111111111111111111111111111111111111
100000000011111000100010001000001010000000001
110111110000100010001000101011100010000000S01
100100000110001010111111101010101010111111111
101101110010111110100000000000101000000000001
101001000010100010101110111111101111110111011
101110101110001010100010001000001000010101001
100010100111111010111011101011111010000001011
111010001000000010100000001000000011111111001
100001111010010010101111011111111100000001101
111100000010111110100010000100000001110101101
100011101110100010111111110001111111010100001
101000100000101010101000011111000001000101111
101110111101000110101010100000011111011100001
110010000100010010101010001110100000001011111
101010111110110110100001110000101111000001001
101010000000100010101111000111101111111101101
100011111011101010100001010000001000000010001
101010000010001010101101111111000010101000101
101000101110111010100100000100001101010111101
101010100010100010111111110111100100000000101
101010001000001000100000000100000100101010001
111111111111111111110000111111111111111111111
1111111111111111111100001
1111111111111111111100001111111
1111111111111100000000000000001
1111111111111100000000000000001
1111111111111100000000000000001
1111111111111100000000000000001
1111111111111100000000000000001
1111111111111100000000000000001
1111111111111111111111111111111
