NO ./textures/blackandwhite_theme/ronds.xpm
SO ./textures/blackandwhite_theme/des.xpm
WE ./textures/blackandwhite_theme/losanges.xpm
EA ./textures/blackandwhite_theme/briques.xpm
   F	   	255,0,255




C 0,128,255

11111111111111111
10000001000000001
10000000000001001
10001010001000001
10000000000000011
10100001000000101
10000000S00000101
11111111111111111
